NO ./textures/bluestone.xpm
SO ./textures/colorstone.xpm
WE ./textures/eagle.xpm
EA ./textures/wood.xpm
F 0,0,0
C 50, 105, 168

111	111
101 11111111
111   101
     101
11111001
1000E11
11111
	
1111
1001
1111