NO ./textures/bluestone.xpm
SO ./textures/colorstone.xpm
WE ./textures/eagle.xpm
EA ./textures/wood.xpm
F 0,0,0
C 50, 105, 168


111111111111111111111
100000000000000000001
100000000011000000001
100000001000111000001
100000001000111000001
100000001000111000001
100000000110000000001
100000001001000000001
100000001001000000001
100000000110000000001
1000000000000000N0001
100000000000000000001
111111111111111111111
